##########################
#          #        E    #
#          #             #
#  ############ ##########
#      S                 #
##########################
